***********************
*        * *          *
*        * *          *
******** * ******** ***
*                     *
******** * ******** ***
*      * * *          *
         * *    *******
***********************
